......W........
.WWWWWW.WWWWWW.
........W......
WWWWW.WWW.WWWWW
E.....W....W.W.
WWWWWWWWWW.W.W.
.........W.W...
WWWWWW.WWW.W.WW
.......W.....W.
.WWWWWWW.WWWWW.
..........W....
WWWW.WWWW.WWWW.
...W.W.........
.WWW.W.WWWWWWWW
.....W.........